XOOOOOOOOOOOOOOOOOOOOOOOOOOOOOOOOOOOOOOOOOOOOOOOOOOOOOOOOOOOOOX
XOOOOOOOOOOOOOOOOOOGGGGGGGGGGGGGGGGGGGGGOOOOOOOOOOOOOOOOOOOOOOX
XOOOOOOOOOOOOOOOOOGOOOOOOOOOOOOOOOOOOOOOGOOOOOOOOGGGGGGGGOOOOOX
XOOOOOOOOOOOOOCOOGOOOOOOOODDDDDDDDDDDDOOOGGGGGGGGOOOOOOOOOOOOOX
XGGOOOGGGGGGGGGGGOOOOOOOOODOOOOOOOOOODOOOOOOOOOOOOOOOOOOOOOOOOX
XOOOOOOOOOOOOOOOOOOOOOOOOOOOOOOOOOOOODOOOOOOOOOOOOOOOOOOOOOOOOX
XOOOOOOOOOOOOOOOOOOOOOOOOOOOOOOOOOOOODOOOOOOOOOOOOOOOOOOOOOOOOX
XGGGGGGGGGGGGGGGGGGGGGGGGGDDDDDDDDOOODGGGGGGGGGGGGGGGGGGGGGGGOX
XOOOOOOOOOOOOOOOOOOOOOOOOOOOOOOOOODOOOOOOOOOOOOOOOOOOOOOOOOOOOX
XOOOOOOOOOOOOOOOOOOOOOOOOOOOOOOOOOODDDDDDDDDDDDDDDDDDDDDDDDDDOX
XOOOOOOOOOOOOOOOOOOOOOOOOOOOOOOOOOOOOOOOOOOOOOOOOOOOOOOOOOOOOOX
XDDDDDDDDDDDDDDDDDDDDDDDDDDDDDDDDDDDDDDDDDDDDDDDDDDDDDDDDDDDDDX
