XOOOOOOOOOOOOOOOOOOOOOOOOOOOOOOOOOOOOOOOOOOOOOOOOOOOOOOOOOOOOOX
XOOOOOOOOOOOOOOOOOOGGGGGGGGGGGGGGGGGGGGGOOOOOOOOOOOOOOOOOOOOOOX
XOOOOOOOOOOOOOOOOOGOOOOOOOOOOOOOOOOOOOOOGOOOOOOOOGGGGGGGGOOOOOX
XOOOOOOOOOOBOOOOOGOOOOOOOODDDDDDDDDDDDOOOGGGGGGGGOOOOOOOOOOOOOX
XGGOOOGGGGGGGGGGGOOOOOOOOODOOOOOOOOOODOOOOOOOOOOOOOOOOOOOOOOOOX
XOOOOOOOOOOOOOOOOOOOOOOOOOOOOOOOOOOOODOOOOOOOOOOBOOOOOOOOOOOOOX
XOOOOOOOOOOOOOOOOOOOOOOOOOOOOOOOOOOOODOOOOOOOOOBBBOOOOOOOOOOOOX
XGGGGGGGGGGGGGGGGGGGGGGGGGDDDDDDDDOOODGGGGGGGGGGGGGGGGGGGGGGGOX
XOOOOOOOOOOOOOOOOOOOOOOOOOOOOOOOOODOOOOOOOOOOOOOOOOOOOOOOOOOOOX
XOOOOOOOOOOOOOOOOOOOOOOOOOOOOOOOOOODDDDDDDDDDDDDDDDDDDDDDDDDDOX
XOOOOOOOOOOOOOOOOOOOOOOOOOOOOOOOOOOOOOOOOOOOOOOOOOOOOOOOOOOOOOX
XDDDDDDDDDDDDDDDDDDDDDDDDDDDDDDDDDDDDDDDDDDDDDDDDDDDDDDDDDDDDDX
