0000000000000000000000000000000000000000000000000000000000000000000000000000000000000000000000000000
0000000000000000000000000000000000000000000000000000000000000000000000000000000000000000000000000000
0000000000000000000000000000000000000000000000000000000000000000000000000000000000000000000000000000
0000000000000000000000000000000000000000000000000000000000000000000000000000000000000000000000000000
0000000000000000000000000000000000000000000000000000000000000000000000000000000000000000000000000000
0000000000000000000000000000000000000000000000000000000000000000000000000000000000000000000000000000
0000000000000000000000000000000000000000000000000000000000000000000000000000000000000000000000000000
0000000000000000000000000000000000000000000000000000000000000000000000000000000000000000000000000000
000000000000000000000000C000000000000000000000000000000000000000000000000000000000000000000000000000
0000000000000000000000000000000000000000000000000000000000000000000000000000000000000000000000000000
00000000000000000002GGGGGGGGGG3000000000000000000000000000000000000000000000000000000000000000000000
0000000000000C00000000000000000000000000000000000000000000000000000000000000000000000000000000000000
000000000002GGG3000000000000000000000000000000000000000000000000000000000000000000000000000000000000
00000000000000000002GGGGGGG30000000000C0000000000000000000000000000000000000000000000000000000000000
00000000000000000000000000000002GGGGGGGGG30000000000000000000000000000000000000000000000000000000000
0000000000000000000000000000002400000000000000000000000000000000000000000000000000000000000000000000
30000000000000002GGGGGGGGGGGGG4000000000000000000000000000000000000000000000000000000000000000000000
7G30000000000000000000000000000000000000000000000000000000000000000000000000000C00000000000000000000
777GGGGGGGGGGGGGGGGGGGGGGGGGGGGGGGGGGGGGG3002GGGGGGGGGGGGGGGGGGGGGGGGGGGGGGGGGGGGGGGGGGGGGGGGGGGGGGG
7777777777777777777777777777777777777777777007777777777777777000000000000000777777777777777777777777
777777777777777777777777777777777777777777770000000000000000000000000000C000777777777777777777777777
77777777777777777777777777777777777777777777777777777777777770000BB000000000777777777777777777777777
DDDDDDDDDDDDDDDDDDDDDDDDDDDDDDDDDDDDDDDDDDDDDDDDDDDDDDDDDDDDD000BBBB0000000BDDDDDDDDDDDDDDDDDDDDDDDD
DDDDDDDDDDDDDDDDDDDDDDDDDDDDDDDDDDDDDDDDDDDDDDDDDDDDDDDDDDDDDDDDDDDDDDDDDDDDDDDDDDDDDDDDDDDDDDDDDDDD
DDDDDDDDDDDDDDDDDDDDDDDDDDDDDDDDDDDDDDDDDDDDDDDDDDDDDDDDDDDDDDDDDDDDDDDDDDDDDDDDDDDDDDDDDDDDDDDDDDDD
