000000000000000000000000000000000000000000000000000000000000000000000000000000000000000000000000000000000000000000000000000000000000000000000000000000
000000000000000000000000000000000000000000000000000000000000000000000000000000000000000000000000000000000000000000000000000000000000000000000000000000
000000000000000000000000000000000000000000000000000000000000000000000000000000000000000000000000000000000000000000000000000000000000000000000000000000
0000000002GGGG3000000000000000000000000000000000000000000000000000000000000000000000000000000000000000000000000000000000000000000000000000000000000000
0000000000000000002GGGGG300000000000000000000000000000000000000000000000000000000G0000G00000002GGG30000000000000000000000000000002GGGGGGGGGGGGGGGGGG30
000000000000000000000000000000000000000000000000000000000000000000000000000000000000000000000000000000000000000000000000000G00000000000000000000000000
00000000000000000000000000002GGGGGGG300000G0000000000000000000000000000000000000000000000000000000000002GG30000000000000000000000000000000000000000000
0000000000000000000000000002400000000000000000002GGGG30000G000G000G0000G000000000000000000000000000000000000000000000000G00000000000000000000000000000
000000000000000000002GGGGGG40000000000000000000000000000000000000000000000000000000000000000000000000000000000000000000000000G000000000000000000000000
00000000000000000000000000000000000000000000000000000000000000000000000000000000000000000000000002GG30000000000000000000000000000000G00000000000000000
000000000000000G00000000000000000000000000000000000000000000000000000000000000000000000000000000000000000000000000000000000000000000000000000000000000
0000000000000000000000000000000000000000000000000000000000000000002GG300000000000000000000000000000000000000000000000000000000000G00000000000000000000
00000000000000000000000000000000000000000000000000000000000000000000000000000003000000000000000000000002G300000000000000000000000000000000000000000000
000000002GGGGG30000000000000000000000000000000000000000000000000000000000000000030000000000000000000000000000000000000000000G0000000000000000000000000
00000000000000000002GGGGGG3000002GGGGGG300000000000000000000000000000000000000000300000000000000000000000000000000000000000000000000000000000000000000
0000000000000000000000000000000000000005300000000000000000000000000000000000000000000000000000000002G30000000000000000000000000G0000000000000000000000   
000000000000000000000000000000000000000053000000000000000000000000000000000000000000000000000000000000000000000000000000000000000000000000000000000000
000000000000000000000000000000000000000005GGGGGGG30000G0000000000000000000000000000000000000000000000000000000000000000000000000002G300000000000000000
000000000002GGGG3000000000000000000000000000000000000000002GGG3000000000000000000000000000000000000002GG3000000000000000000000000000000000000000000000
0GG3000000000000000000000000000000000000000000000000000000000000000000000000000000000000000000000000000000000000000000000002GGG30000000000000000000000   
0000000000000000000000000000000000000000000000002GGGGGG30000000G00000000000000000030000000000000000000000000000000000000000000000000000000000000000000
0000000000000000000000000000000000G0002GG300000000000000000000000000000000000000000000000000000002G3000000000000002GGGGG200000000000000000000000000000
G300000000000000000000000000000000000000000000000000000000000000G0000000000000000003000000000000000000000000000002400000000000000000000000000000000000   
00G300000000000000000000000000000003000000000000000000000000000000000000000000002000300000000000000000000000000024000000000000000000000000000000000000   
0000GGGGGGGGGGG3000000002GG000000000GGGGGGG3000002G66666GGGGGGGGGGGGGGGGGGGGGGGG00000GGGGGGGGGGGGGGGGGGGGGGGGGGG0GGGGGGGGGGGGGGGGGGGGGGGGGGGGGGGGGGGGG
0000000000000000GG300002000000000000000000000000000000000000000000000000000000000000000000000000000000000000000000000000000000000000000000000000000000
000000000000000000030000000000000000000000000000000000000000000000000000000000000000000000000000000000000000000000000000000000000000000000000000000000
000000000000000000000000000000000000000000000000000000000000000000000000000000000000000000000000000000000000000000000000000000000000000000000000000000
000000000000000000000000000000000000000000000000000000000000000000000000000000000000000000000000000000000000000000000000000000000000000000000000000000
000000000000000000000000000000000000000000000000000000000000000000000000000000000000000000000000000000000000000000000000000000000000000000000000000000