0000000000000000000000000000000000000000000000000000000000000000000000000000000000000000000000000000
0000000000000000000000000000000000000000000000000000000000000000000000000000000000000000000000000000
0000000000000000000000000000000000000000000000000000000000000000000000000000000000000000000000000000
0000000000000000000000000000000000000000000000000000000000000000000000000000000000000000000000000000
0000000000000000000000000000000000000000000000000000000000000000000000000000000000000000000000000000
0000000000000000000000000000000000000000000000000000000000000000000000000000000000000000000000000000
0000000000000000000000000000000000000000000000000000000000000000000000000000000000000000000000000000
0000000000000000000000000000000000000000000000000000000000000000000000000000000000000000000000000000
0000000000000000000000000000000000000000000000000000000000000000000000000000000000000000000000000000
000002GGG3000000000000000000000000000000000000000000000000000000000000000000000000000000000000000000
00000000000000000002GGGGGGGGGG3000000000000000000000000000000000000000000000000000000000000000000000
0000000000000000000000000000000000000000000000000000000000000000000000000000000000000000000000000000
000000000002GGG3000000000000000000000000000000000000000000000000000000000000000000000000000000000000
00000000000000000002GGGGGGG3000000000000000000000000000000000000000000000000000000000000000000000000
00000000000000000000000000000002GGGGGGGGG30000000000000000000000000000000000000000000000000000000000
0000000000000000000000000000002400000000000000000000000000000000000000000000000000000000000000000000
G3000000000000002GGGGGGGGGGGGG4000000000000000000000000000000000000000000000000000000000000000000000
00G3000000000000000E0E0E0E00000000000000000000000000000000000000000000000000000000000000000000000000
0000GGGGGGGGGGGGGGGGGGGGGGGGGGGGGGGGGGGGG30002GGGGG300002GGGGGGGGGGGGGGGGGGGGGGGGGGGGGGGGGGGGGGGGGGG
0000000000000000000000000000000000000000003000000000GGGG00000000000000000000000000000000000000000000
0000000000000000000000000000000000000000000300000000000000000000000000000000000000000000000000000000
0000000000000000000000000000000000000000000000000000000000000000000000000000000000000000000000000000
0000000000000000000000000000000000000000000000000000000000000000000000000000000000000000000000000000
0000000000000000000000000000000000000000000000000000000000000000000000000000000000000000000000000000
0000000000000000000000000000000000000000000000000000000000000000000000000000000000000000000000000000