X000000000000000000000000000000000000000000000000000000000000000000000000000000000000000000000000000000000000000000000000000000000000000000000000000CX
X000000000000000000000000000000000000000000000000000000000000000000000000000000000000000000000000000000000000000000000000000000000000000000000000000BX
X00000000F0C00F000000000000000000000000000000000000000000000000000000000000000000000000000000000000000000000000000000000000000000000000000000000000BBX
X000000002GGGG30000000000000000000000000000000000000000000000000000000000000000000000000000000FEC0F0000000000000000000000000000000F00E00000E00000EBBBX
X000000000000000002GGGGG3000000000000000000000000000000000000000000000000000D0000G0000G00000002GGG300000000000000000000000000000002GGGGGGGGGGGGGGGGG3X
X000000000000000000000000000F000E0C0F000000000000000000000000000000000000000D0000000000000000000000000000000000000000000000G0000000000000000000000000X
X0000000000000000000000000002GGGGGGG300000G00000000000000000000000000000000DD000000000000000000000000002GG3000000000000000000000000000000000000000000X
X000000000000000000000000002400000000000000000002GGGG30000G000G000G0000G0000DD000000000000000000000000000000000000000000G0000000000000000000000000000X
X00000000000000000002GGGGGG4000000000000000000000000000000000000000000000000DD00000000000000000000000000000000000000000000000G00000000000000000000000X
X000000000000000000000000000000000000000000000000000000000000000000000000000DD00000000000000000002GG30000000000000000000000000000000G0000000000000000X
X00000000000000G000000000000000000000000000000000000000000000000000C00000000D7D0000000000000000000000000000000000000000000000000000000000000000000000X
X000000000000000000000000000000000000000000000000000000000000000002GG3000000D7700000000000000000000000000000000000000000000000000G0000000000000000000X
X0000000000000000000000000000000000000000000000000000000000000000000000000000D73000000000000000000000002G30000000000000000000000000000000000000000000X
X00000002GGGGG300000000000000000F0C0E00F000000000000000000000000000000000000007730000000000000000000000000000000000000000000G000000000000000000000000X
X0000000000000000002GGGGGG3000002GGGGGG30000000000000000000000000000000000000007730000000000000000000000000000000000000000000000000000000000000000000X
X000000000000000000000000000000000000005300000000000000000000000000000000000000077000000000000000002G30000000000000000000000000G000000000000000000000X   
X00000000000000000000000000000D0000000005300000000000000000000000000000000000000770000000000000000000000000000000000000000000000000000000000000000000X
X00000000000000000000000000000DD0000000005GGGGGGG30000G0000000000000000000000000770000000000000000000000000000000000000000000000002G30000000000000000X
XC0000000002GGGG300000000000CDDD000000000000000000000000002GGG3000000000000000077000000000000000000002GG300000000000000000000000000000000000000000000X
XGG3000000000000000000000000DDDDD00000000000000F0000E0CF00000000000000000000000770000000000000000000000000000000000000000002GGG3000000000000000000000X   
X000000000000000000000000007DDDDD700000C00000002GGGGGGG30000000G0000000000000000773000000000000000000000000000000000000000000000000000000000000000000X
X000000000000000000000000007777777G0002GGG3000000000B000000000000000000000000000077000000000000002G3000000000000002GGGGG20000000000000000000000000000X
X300000000000000000000000007777777000000000000000000BB0000000000G000000000000000077300000000000000000000000000000240000000000000000000000000000000000X   
X7G300000000000000000000000777777773000000000000000BBBBB00000E000000C0000E0F000027773E0C00000000000000E0F0000000240E000000C000000000E0F00000000000000X   
7777GGGGGGGGGGG3000000002GG777777777GGGGGGG3000002G66666GGGGGGGGGGGGGGGGGGGGGGGG77777GGGGGGGGGGGGGGGGGGGGGGGGGGG7GGGGGGGGGGGGGGGGGGGGGGGGGGGGGGGGGGGGG
7777777777777777GG300002777777777777777777700007777777777777777777777777777777777777777777777777777777777777777777777777777777777777777777777777777777
777777777777777777730000077777000000000000000777777777777777777777777777777777777777777777777777777777777777777777777777777777777777777777777777777777
DDDDDDDDDDDDDDDDDDDDDD00000DDD0000000000CDDDDDDDDDDDDDDDDDDDDDDDDDDDDDDDDDDDDDDDDDDDDDDDDDDDDDDDDDDDDDDDDDDDDDDDDDDDDDDDDDDDDDDDDDDDDDDDDDDDDDDDDDDDDD
DDDDDDDDDDDDDDDDDDDDDDD000000F0000000E00BDDDDDDDDDDDDDDDDDDDDDDDDDDDDDDDDDDDDDDDDDDDDDDDDDDDDDDDDDDDDDDDDDDDDDDDDDDDDDDDDDDDDDDDDDDDDDDDDDDDDDDDDDDDDD
DDDDDDDDDDDDDDDDDDDDDDDDDDDDDDDDDDDDDDDDDDDDDDDDDDDDDDDDDDDDDDDDDDDDDDDDDDDDDDDDDDDDDDDDDDDDDDDDDDDDDDDDDDDDDDDDDDDDDDDDDDDDDDDDDDDDDDDDDDDDDDDDDDDDDD