X00000000000000000000000000000000000000000000000000000000000000000000000000000000000000000000000000X
X00000000000000000000000000000000000000000000000000000000000000000000000000000000000000000000000000X
X00000000000000000000000000000000000000000000000000000000000000000000000000000000000000000000000000X
X00000000000000000000000000000000000000000000000000000000000000000000000000000000000000000000000000X
X00000000000000000000000000000000000000000000000000000000000000000000000000000000000000000000000000X
X00000000000000000000000000000000000000000000000000000000000000000000000000000000000000000000000000X
X00000000000000000000000000000000000000000000000000000000000000000000000000000000000000000000000000X
X00000000000000000000000000000000000000000000000000000000000000000000000000000000000000000000000000X
X00000000000000000000000000000000000000000000000000000000000000000000000000000000000000000000000000X
X00000000000000000000000000000000000000000000000000000000000000000000000000000000000000000000000000X
X00000000000000000000000000000000000000000000000000000000000000000000000000000000000000000000000000X
X00000000000000000000000000000000000000000000000000000000000000000000000000000000000000000000000000X
X00000000000000000000000000000000000000000000000000000000000000000000000000000000000000000000000000X
X00000000000000000000000000000000000000000000000000000000000000000000000000000000000000000000000000X
X00000000000000000000000000000000000000000000000000000000000000000000000000000000000000000000000000X
X00000000000000000000000000000000000000000000000000000000000000000000000000000000000000000000000000X
X00000000000000000000000000000000000000000000000000000000000000000000000000000000000000000000000000X
770000000000000000000000000000000000000000000000000000000000000000000000000000000000000000000000000X
777700000000000000000000000000000000000000000000000000000000000000000000000000000000000000000000000X
7777777777777777777777777777777777777777770000777777000077777000000000000000777777777777777777777777
7777777777777777777777777777777777777777777000000000000000000000000000000000777777777777777777777777
77777777777777777777777777777777777777777777777777777777777770000BB000000000777777777777777777777777
DDDDDDDDDDDDDDDDDDDDDDDDDDDDDDDDDDDDDDDDDDDDDDDDDDDDDDDDDDDDD000BBBB0000000BDDDDDDDDDDDDDDDDDDDDDDDD
DDDDDDDDDDDDDDDDDDDDDDDDDDDDDDDDDDDDDDDDDDDDDDDDDDDDDDDDDDDDDDDDDDDDDDDDDDDDDDDDDDDDDDDDDDDDDDDDDDDD
DDDDDDDDDDDDDDDDDDDDDDDDDDDDDDDDDDDDDDDDDDDDDDDDDDDDDDDDDDDDDDDDDDDDDDDDDDDDDDDDDDDDDDDDDDDDDDDDDDDD